32 18
0 0 0 0 0 0 0 0 0 0 0 0 0 0 0 0 0 0 0 0 0 0 20 0 0 0 0 0 0 0 0 0 
0 0 0 0 0 0 0 0 0 0 0 0 0 0 0 0 0 0 0 0 0 0 20 0 0 0 0 0 0 0 0 0 
0 0 0 0 0 0 0 0 0 0 0 0 0 0 0 0 0 0 0 0 0 0 20 0 0 0 0 0 0 0 0 0 
0 0 0 0 0 0 0 0 0 0 0 0 0 0 0 0 0 0 0 0 0 0 20 0 0 0 0 0 0 0 0 0 
0 0 0 0 0 0 0 0 0 0 0 0 0 0 0 0 0 0 0 0 0 0 20 0 0 0 0 0 0 0 0 0 
0 0 0 0 0 0 0 0 0 0 0 0 0 0 0 0 0 0 0 0 0 0 41 12 0 0 0 0 0 0 0 0 
0 0 0 0 0 0 0 0 0 0 0 0 0 0 0 0 0 0 0 0 0 0 17 55 36 32 37 12 0 0 0 0 
0 0 0 0 0 0 0 0 0 0 10 12 0 0 0 0 0 0 0 0 13 0 34 25 35 0 17 55 12 0 0 0 
0 0 0 0 0 0 0 0 0 14 44 43 15 0 0 0 0 0 0 0 28 32 29 0 41 11 52 25 35 0 0 0 
0 0 0 0 0 0 0 0 31 21 0 0 22 33 0 0 0 0 0 0 0 0 0 14 44 49 19 0 22 32 32 37 
0 0 0 0 0 0 0 0 0 28 37 36 29 0 0 0 0 0 0 0 0 0 0 20 0 17 55 11 42 0 0 17 
0 0 0 0 0 0 0 0 0 0 17 19 0 0 0 0 0 0 0 0 0 0 0 20 0 34 25 49 45 32 37 56 
0 0 0 0 0 0 0 0 0 10 56 55 12 0 0 0 0 0 0 0 0 0 0 20 0 20 0 17 19 0 17 18 
0 0 0 0 0 0 14 32 32 38 18 18 45 32 32 15 0 0 0 0 0 0 0 20 0 20 0 34 43 39 44 49 
0 0 0 0 10 36 29 0 0 24 25 25 26 0 0 28 37 12 0 0 0 0 0 27 0 20 0 20 0 20 0 17 
0 0 0 0 24 26 0 0 0 0 0 0 0 0 0 0 24 26 0 0 0 0 0 0 0 20 0 41 11 47 11 56 
0 0 0 0 0 0 0 0 0 0 0 0 0 0 0 0 0 0 0 0 0 0 0 0 0 20 0 34 25 49 18 18 
0 0 0 0 0 0 0 0 0 0 0 0 0 0 0 0 0 0 0 0 0 0 0 0 0 41 11 42 0 17 18 18 
